................................................................
................................................................
................................................................
................................................................
................................................................
......................?.........................................
................................................................
................................................................
................................................................
................?...b?b?b.....................12.........12.....
......................................12......34.........34.....
............................12........34......34.........34.....
............................34........34......34.........34.....
GGGGGGGGGGGGGGGGGGGGGGGGGGGGGGGGGGGGGGGGGGGGGGGGGGGGGGGGGGGGGGGG
GGGGGGGGGGGGGGGGGGGGGGGGGGGGGGGGGGGGGGGGGGGGGGGGGGGGGGGGGGGGGGGG