................................................................
................................................................
................................................................
................................................................
................................................................
......................?.........................................
................................................................
................................................................
................................................................
................?...b?b?b.....................12.........12BGBGb
......................................12......34.........34...bb
............................12........34......34.........34...bb
............................34........34......34.........34...bb
GGGGGGGGGGGGGGGGGGGGGGGGGGGGGGGGGGGGGGGGGGGGGGGGGGGGGGGGGGGGGGGG
GGGGGGGGGGGGGGGGGGGGGGGGGGGGGGGGGGGGGGGGGGGGGGGGGGGGGGGGGGGGGGGG