................................
................................
................................
................................
................................
......................?.........
................................
................................
................................
................?...b?b?b.......
................................
................................
................................
GGGGGGGGGGGGGGGGGGGGGGGGGGGGGGGG
GGGGGGGGGGGGGGGGGGGGGGGGGGGGGGGG